1111111111111111111111111111111111111111
100000000000000000000E000000000000000001
1000000000000000000000000000000000000001
1000000000000000000000000000000000000001
1000000000000000000000000000000000000001
1000000000000000000000000000000000000001
1000000000000000000000000000000000000001
10000000000000000000C1000000000000000001
1000000000000000001110000000000000000001
1000000000000000010001000000000000000001
1000000000000000100001000000000000000001
1000000000000001000001000000000000000001
1000000000000001000001000000000000000001
1000000000000001000001000000000000000001
1000000000000001000001000000000000000001
1000000000000001000001000000000000000001
1000000000000001000001000000000000000001
1000000000000000000000000000000000000001
1000000000000000000000000000000000000001
100000000000000000000P000000000000000001
1111111111111111111111111111111111111111
