111111111111111111111111111111111111111
101000111110111010100000000000C01100011
101010111111101110000100000001100000001
1000000P000000100011111C011100000000011
101110101110101011101100000000100000001
111111101100010001011100010000000C00101
1000111000001010111011C1111011110000111
101010101110000100101000C00000000011101
1110111010001000000000111110000001C0011
1000C00C101010000000E1110000C0000000001
100000000000000000000000000000000000001
100000000000000000000000000000000000001
100000000000000000000000000000000000001
100000000000000000000000000000000000001
100000000000000000000000000000000000001
100000000000000000000000000000000000001
100000000000000000000000000000000000001
100000000000000000000000000000000000001
100000000000000000000000000000000000001
100000000000000000000000000000000000001
100000000000000000000000000000000000001
111111111111111111111111111111111111111
