1111111111111111111111111111111111111111
1010001111101110101000000000000C01100011
1010101111111011100001000000001100000001
1000000P000000100011111C0111100000000011
1011101011101010111011000000000100000001
1111111011000100010111000100000000C00101
1000111000001010111011C11111011110000111
101010101110000100101000C000000000011101
11101110100010000000001111100000001C0011
1000C00C101010000000E11100000C0000000001
1111111111111111111111111111111111111111
