1111111111111111111111111111111111111111
1000000000000000001E10000000000000000011
1011110111101111001010011110111101111011
101111C1111011110010100111101111C1111011
10111101111C111100101001111C111101111011
1011110111101111001010011110111101111011
1000000000000000000000000000000000000011
1000000000000000000000000000000000000011
1000000000000000000000000000000000000011
1011110111101111001010011110111101111011
10111101111C111100101001111C111101111011
101111C1111011110010100111101111C1111011
1011110111101111001010011110111101111011
1000000000000000001P10000000000000000011
1111111111111111111111111111111111111111
1111111111111111111111111111111111111111
1111111111111111111111111111111111111111
1111111111111111111111111111111111111111
1111111111111111111111111111111111111111
1111111111111111111111111111111111111111
1000000000000000000000000000000000000001
1111111111111111111111111111111111111111
1111111111111111111111111111111111111111
