11111111111111111111111111111111111111111
1000000000000000001E100000000000000000111
10111101111011110010100111101111011110111
101111C1111011110010100111101111C11110111
10111101111C111100101001111C1111011110111
10111101111011110010100111101111011110111
10000000000000000000000000000000000000111
10000000000000000000000000000000000000111
10000000000000000000000000000000000000111
10111101111011110010100111101111011110111
10111101111C111100101001111C1111011110111
101111C1111011110010100111101111C11110111
10111101111011110010100111101111011110111
1000000000000000001P100000000000000000111
11111111111111111111111111111111111111111
11111111111111111111111111111111111111111
11111111111111111111111111111111111111111
11111111111111111111111111111111111111111
11111111111111111111111111111111111111111
11111111111111111111111111111111111111111
10000000000000000000000000000000000000011
11111111111111111111111111111111111111111